1111111111111111111111111
0000000000001110000001111
1110101111000001101000001
1000110100001111111111101
1011010111100000000001101
1000010000001100000100001
1111010111011101111101111
1000000001000001000000001
1111110110000101101011111
1000010111111101011000001
1011110000000000000011101
1100000011101111111110001
1111110110001000000000111
1000000000101011111110101
1001111110101000000001001
1000000010111011111100000
1111111110000000000001111
1000000001111111111100011
1000000000000000000000011
1111111111111111111111111
