1111111111111111111111111
1000000000000000000000001
1111111111111111111111101
1000000000000000000000101
1011111111111111111110101
1010000000000000000010101
1010111111111111111010101
1010100000000000001010101
1010101111111111101010101
1010101000000000101010101
1010101011111110101010101
1010101010000010101010101
1010101010101010101010101
1010101010100010101010101
1010101010111110101010101
1010101010000000101010101
1010101011111111101010101
1010101000000000001010101
1010101111111111111010101
1010100000000000000010101
1010111111111111111110101
1010000000000000000000101
1011111111111111111111101
1000000000000000000000001
1111111111111111111111111