1111111111111111111111111
0000000000011110030010101
1110101111000000101000001
1000110100011111111111101
1011010111100001000001101
1000010000001100010100001
1111010111011101111101111
1000300001010001000300001
1111110110000101101011111
1000010111111101011000001
1011110000000000000011101
1000000111222221111110001
1111110101999991003000111
1000000001111111111110101
1011111110000000000000001
1000000010101010101101100
1010101010000030000001111
1010101011111111111101101
1000000000000000000000001
1111111111111111111111111
